W  W  W  W  W  W  W  W  W  W  W
W                             W
W     W  W     W     W  W     W
W     W                 W     W
W     W     W  W  W     W     W
W              P        W     W
W     W     W  W  W     W     W
W     W                 W     W
W     W  W     W     W  W     W
W              W        M     W
W                             W
W  W  W  W  W  W  W  W  W  W  W